800
500
13 11 11 11 11 11 11 11 11 11 11 11 11 11 11 13
13 02 01 02 02 01 02 02 01 02 02 02 02 01 02 13
13 01 02 01 02 02 01 02 02 02 01 01 02 01 01 13
13 01 02 01 02 02 01 02 02 02 01 01 02 01 01 13
13 02 01 02 02 01 02 02 01 02 02 02 02 01 02 13
13 01 02 01 02 02 01 02 02 02 01 01 02 01 01 13
13 01 02 01 02 02 01 02 02 02 01 01 02 01 01 13
13 02 01 02 02 01 02 02 01 02 02 02 02 01 02 13
11 11 11 11 11 11 11 11 01 01 11 11 11 11 11 11
13 12 12 12 12 12 12 12 01 02 12 12 12 12 12 12
